[ 73/ 92] [ 73/ 91] [ 65/ 94] [ 67/ 91] [ 66/ 92] [ 65/ 86] [ 70/ 90] [ 64/ 90] [ 66/ 87] [ 65/ 87] [ 68/ 93] [ 73/ 94] [ 65/ 94] [ 72/ 92] [ 66/ 85] [ 68/ 94] [ 72/ 89] [ 72/ 90] [ 67/ 87] [ 70/ 90] [ 64/ 92] [ 64/ 88] [ 71/ 85] [ 69/ 85] [ 70/ 93] [ 66/ 87] [ 69/ 91] [ 65/ 87] [ 65x 86] [ 71/ 85] 
[ 66/ 91] [ 69/ 94] [ 68/ 85] [ 70/ 85] [ 66/ 85] [ 68/ 85] [ 65/ 91] [ 69/ 93] [ 64/ 90] [ 66/ 87] [ 72/ 87] [ 72/ 88] [ 70/ 93] [ 66/ 88] [ 70/ 94] [ 65/ 87] [ 66/ 85] [ 66/ 85] [ 71/ 91] [ 68/ 90] [ 68/ 89] [ 66/ 88] [ 68/ 90] [ 69/ 92] [ 66/ 88] [ 70/ 90] [ 71/ 93] [ 73/ 92] [  0/ 94] [ 69/ 93] 
[ 73/ 85] [ 66/ 89] [ 66/ 94] [ 67/ 91] [ 72/ 86] [ 67/ 89] [ 66/ 93] [ 64/ 87] [ 68/ 94] [ 66/ 89] [ 69/ 90] [ 66/ 92] [ 66/ 93] [ 70/ 90] [ 68/ 92] [ 65/ 89] [ 65/ 91] [ 67/ 86] [ 70/ 85] [ 65/ 91] [ 64/ 91] [ 67/ 90] [ 64/ 94] [ 64/ 85] [ 67/ 92] [ 69/ 88] [ 65/ 88] [ 71/ 91] [ 65/ 89] [ 70/ 90] 
[ 68/ 85] [ 72/ 94] [ 72/ 89] [ 66/ 93] [ 67/ 90] [ 71/ 92] [ 65/ 88] [ 71/ 90] [ 68/ 92] [ 73/ 86] [ 67/ 89] [ 65/ 87] [ 72/ 85] [ 73/ 90] [ 71/ 86] [ 66/ 93] [ 64/ 90] [ 66/ 85] [ 68/ 89] [ 72/ 87] [ 68/ 90] [ 70/ 87] [ 64/ 86] [ 72/ 88] [ 66/ 91] [ 70/ 85] [ 69/ 88] [ 73/ 85] [ 68/ 86] [ 65/ 91] 
[ 67/ 87] [ 65/ 89] [ 70/ 88] [ 70/ 94] [ 67/ 91] [ 66/ 93] [ 73/ 90] [ 64/ 89] [ 68/ 92] [ 73/ 88] [ 66/ 90] [ 70/ 93] [ 71/ 93] [ 72/ 86] [ 71/ 90] [ 72/ 90] [ 67/ 88] [ 66/ 93] [ 66/ 90] [ 67/ 87] [ 72/ 94] [ 71/ 91] [ 69/ 86] [ 68/ 87] [ 70/ 85] [ 72/ 90] [ 64/ 87] [ 73/ 86] [ 73/ 86] [ 71/ 92] 
[ 69/ 88] [ 69/ 89] [ 71/ 91] [ 71/ 94] [ 72/ 94] [ 73/ 89] [ 64/ 86] [ 70/ 92] [ 66/ 91] [ 70/ 94] [ 72/ 89] [ 72/ 89] [ 67/ 93] [ 72/ 85] [ 68/ 92] [ 73/ 94] [ 71/ 91] [ 64/ 85] [ 65/ 87] [ 64/ 91] [ 70/ 93] [ 67/ 89] [ 71/ 94] [ 70/ 85] [ 65/ 85] [ 72/ 85] [ 73/ 88] [ 70/ 93] [ 70/ 90] [ 67/ 89] 
[ 68/ 88] [ 66/ 87] [ 69/ 88] [ 70/ 94] [ 66/ 85] [ 71/ 87] [ 73/ 91] [ 72/ 87] [ 73/ 94] [ 73/ 91] [ 65/ 88] [ 71/ 93] [ 71/ 87] [ 65/ 92] [ 65/ 94] [ 67/ 89] [ 69/ 93] [ 72/ 93] [ 70/ 89] [ 69/ 87] [ 64/ 93] [ 65/ 93] [ 65/ 87] [ 70/ 88] [ 70/ 87] [ 67/ 91] [ 73/ 89] [ 72/ 90] [ 65/ 86] [ 71/ 94] 
[ 66/ 92] [ 64/ 92] [ 66/ 89] [ 64/ 93] [ 66/ 87] [ 70/ 85] [ 65/ 92] [ 66/ 90] [ 65/ 85] [ 73/ 93] [ 72/ 88] [ 66/ 89] [ 71/ 86] [ 72/ 87] [ 67/ 89] [ 70/ 85] [ 66/ 91] [ 65/ 88] [ 71/ 85] [ 72/ 88] [ 70/ 91] [ 69/ 87] [ 70/ 90] [ 70/ 88] [ 70/ 91] [ 66/ 94] [ 69/ 88] [ 64/ 90] [ 64/ 88] [ 71/ 89] 
[ 69/ 89] [ 69/ 85] [ 70/ 90] [ 70/ 90] [ 72/ 91] [ 65/ 91] [ 68/ 93] [ 69/ 94] [ 73/ 90] [ 73/ 85] [ 65/ 93] [ 67/ 93] [ 71/ 85] [ 68/ 86] [ 70/ 87] [ 68/ 86] [ 71/ 87] [ 70/ 92] [ 69/ 91] [ 73/ 91] [ 68/ 87] [ 65/ 87] [ 68/ 86] [ 66/ 92] [ 65/ 93] [ 67/ 89] [ 67/ 86] [ 69/ 85] [ 68/ 92] [ 73/ 87] 
[ 73/ 90] [ 69/ 93] [ 71/ 90] [ 64/ 91] [ 66/ 92] [ 69/ 86] [ 65/ 92] [ 66/ 85] [ 72/ 86] [ 69/ 88] [ 67/ 91] [ 72/ 89] [ 68/ 94] [ 70/ 90] [ 70/ 89] [ 70/ 92] [ 72/ 94] [ 64/ 85] [ 68/ 94] [ 68/ 86] [ 68/ 92] [ 66/ 87] [ 72/ 91] [ 65/ 91] [ 67/ 86] [ 71/ 88] [ 70/ 85] [ 64/ 91] [ 68/ 91] [ 70/ 90] 
[ 72/ 90] [ 70/ 88] [ 69/ 90] [ 72/ 90] [ 70/ 93] [ 71/ 86] [ 67/ 86] [ 71/ 89] [ 72/ 93] [ 65/ 86] [ 68/ 88] [ 65/ 90] [ 69/ 86] [ 67/ 86] [ 70/ 91] [ 65/ 93] [ 69/ 91] [ 72/ 91] [ 71/ 85] [ 68/ 86] [ 71/ 87] [ 65/ 88] [ 68/ 90] [ 68/ 92] [ 72/ 87] [ 66/ 90] [ 65/ 92] [ 64/ 94] [ 73/ 91] [ 70/ 88] 
[ 72/ 87] [ 70/ 87] [ 68/ 85] [ 64/ 88] [ 65/ 89] [ 69/ 88] [ 66/ 91] [ 66/ 91] [ 72/ 91] [ 66/ 88] [ 65/ 85] [ 66/ 91] [ 67/ 93] [ 67/ 93] [ 65/ 91] [ 67/ 88] [ 65/ 92] [ 73/ 93] [ 68/ 93] [ 71/ 94] [ 70/ 89] [ 65/ 85] [ 73/ 88] [ 73/ 90] [ 64/ 88] [ 66/ 93] [ 64/ 85] [ 70/ 93] [ 73/ 88] [ 68/ 87] 
[ 71/ 87] [ 70/ 90] [ 67/ 94] [ 73/ 87] [ 70/ 90] [ 66/ 92] [ 72/ 89] [ 68/ 93] [ 64/ 90] [ 73/ 87] [ 64/ 93] [ 70/ 94] [ 66/ 86] [ 64/ 90] [ 72/ 92] [ 69/ 87] [ 69/ 89] [ 73/ 94] [ 72/ 93] [ 66/ 93] [ 66/ 85] [ 73/ 89] [ 64/ 87] [ 70/ 92] [ 73/ 93] [ 65/ 85] [ 72/ 89] [ 73/ 86] [ 65/ 89] [ 70/ 88] 
[ 71/ 87] [ 64/ 94] [ 70/ 87] [ 73/ 91] [ 69/ 86] [ 65/ 85] [ 72/ 87] [ 66/ 91] [ 71/ 91] [ 65/ 92] [ 65/ 93] [ 64/ 87] [ 71/ 90] [ 72/ 86] [ 66/ 94] [ 67/ 93] [ 66/ 87] [ 65/ 87] [ 70/ 85] [ 69/ 88] [ 69/ 94] [ 66/ 86] [ 68/ 93] [ 65/ 94] [ 71/ 92] [ 68/ 87] [ 67/ 88] [ 66/ 89] [ 64/ 93] [ 73/ 87] 
[ 71/ 90] [ 72/ 89] [ 67/ 94] [ 64/ 94] [ 72/ 85] [ 67/ 86] [ 71/ 92] [ 73/ 87] [ 64/ 85] [ 69/ 92] [ 65/ 87] [ 64/ 88] [ 65/ 85] [ 69/ 93] [ 71/ 88] [ 67/ 85] [ 64/ 89] [ 68/ 85] [ 64/ 90] [ 70/ 85] [ 67/ 93] [ 67/ 92] [ 69/ 93] [ 67/ 94] [ 68/ 89] [ 71/ 88] [ 73/ 87] [ 73/ 90] [ 72/ 89] [ 66/ 93] 
[ 64/ 86] [ 71/ 93] [ 64/ 93] [ 70/ 94] [ 68/ 88] [ 72/ 88] [ 64/ 89] [ 68/ 88] [ 68/ 93] [ 70/ 90] [ 70/ 91] [ 64/ 85] [ 68/ 88] [ 71/ 91] [ 71/ 91] [ 73/ 91] [ 64/ 89] [ 72/ 90] [ 67/ 85] [ 73/ 85] [ 70/ 88] [ 73/ 91] [ 67/ 94] [ 66/ 86] [ 71/ 94] [ 72/ 91] [ 64/ 85] [ 70/ 91] [ 65/ 92] [ 71/ 89] 
[ 69/ 85] [495/502] [495/507] [490/504] [497/501] [492/503] [499/501] [490/506] [497/503] [496/509] [491/506] [496/501] [494/503] [497/503] [499/509] [490/508] [494/503] [495/503] [493/503] [498/507] [492/509] [491/510] [493/510] [493/501] [495/502] [497/505] [492/503] [492/508] [492/506] [492/501] 
[ 68/ 91] [ 73/ 87] [ 70/ 86] [ 69/ 94] [ 67/ 92] [ 70/ 88] [ 71/ 85] [ 72/ 93] [ 68/ 92] [ 65/ 88] [ 67/ 92] [ 71/ 87] [ 67/ 89] [ 64/ 93] [ 69/ 85] [ 65/ 91] [ 72/ 88] [ 64/ 88] [ 73/ 86] [ 65/ 94] [ 72/ 85] [ 71/ 86] [ 64/ 87] [ 70/ 93] [ 68/ 94] [ 69/ 94] [ 64/ 85] [ 70/ 85] [ 67/ 85] [ 71/ 93] 
[ 73/ 85] [ 71/ 88] [ 70/ 94] [ 66/ 92] [ 66/ 94] [ 71/ 87] [ 67/ 86] [ 65/ 86] [ 67/ 85] [ 73/ 92] [ 73/ 93] [ 73/ 89] [ 68/ 93] [ 65/ 90] [ 67/ 86] [ 64/ 86] [ 68/ 91] [ 72/ 94] [ 72/ 92] [ 67/ 92] [ 65/ 89] [ 67/ 86] [ 70/ 92] [ 65/ 92] [ 69/ 90] [ 71/ 87] [ 70/ 91] [ 67/ 90] [ 64/ 92] [ 72/ 88] 
[ 66/ 93] [ 68/ 87] [ 64/ 89] [ 73/ 94] [ 66/ 87] [ 71/ 92] [ 71/ 89] [ 71/ 92] [ 67/ 91] [ 70/ 87] [ 67/ 88] [ 73/ 92] [ 64/ 86] [ 65/ 86] [ 68/ 89] [ 73/ 86] [ 64/ 87] [ 66/ 88] [ 65/ 90] [ 64/ 89] [ 67/ 86] [ 69/ 86] [ 69/ 85] [ 70/ 91] [ 72/ 89] [ 73/ 86] [ 70/ 90] [ 66/ 87] [ 68/ 89] [ 71/ 90] 
[ 66/ 88] [ 73/ 85] [ 70/ 87] [ 66/ 90] [ 69/ 91] [ 69/ 90] [ 67/ 86] [ 65/ 93] [ 71/ 91] [ 64/ 87] [ 69/ 88] [ 66/ 87] [ 66/ 91] [ 66/ 86] [ 72/ 94] [ 68/ 89] [ 72/ 88] [ 70/ 86] [ 64/ 87] [ 67/ 86] [ 67/ 93] [ 70/ 90] [ 68/ 92] [ 69/ 90] [ 70/ 88] [ 69/ 92] [ 72/ 85] [ 73/ 85] [ 72/ 89] [ 67/ 89] 
[ 70/ 85] [ 69/ 93] [ 65/ 92] [ 67/ 89] [ 66/ 93] [ 69/ 91] [ 68/ 92] [ 67/ 93] [ 73/ 91] [ 65/ 92] [ 66/ 85] [ 64/ 91] [ 71/ 90] [ 71/ 86] [ 71/ 86] [ 69/ 89] [ 73/ 92] [ 73/ 87] [ 73/ 90] [ 69/ 93] [ 66/ 90] [ 65/ 92] [ 73/ 86] [ 71/ 93] [ 65/ 93] [ 66/ 85] [ 66/ 94] [ 67/ 92] [ 72/ 86] [ 66/ 90] 
[ 67/ 89] [ 68/ 94] [ 71/ 93] [ 67/ 92] [ 68/ 89] [ 66/ 88] [ 71/ 86] [ 67/ 92] [ 73/ 89] [ 71/ 92] [ 68/ 90] [ 65/ 92] [ 71/ 93] [ 64/ 89] [ 67/ 90] [ 67/ 87] [ 69/ 87] [ 71/ 91] [ 72/ 85] [ 66/ 94] [ 71/ 94] [ 71/ 93] [ 65/ 91] [ 67/ 93] [ 68/ 89] [ 71/ 89] [ 67/ 91] [ 66/ 86] [ 71/ 88] [ 64/ 85] 
[ 64/ 92] [ 71/ 88] [ 64/ 93] [ 68/ 90] [ 68/ 89] [ 68/ 94] [ 68/ 88] [ 72/ 94] [ 70/ 88] [ 69/ 94] [ 71/ 90] [ 66/ 92] [ 68/ 85] [ 68/ 92] [ 69/ 86] [ 65/ 87] [ 68/ 87] [ 67/ 85] [ 73/ 87] [ 72/ 92] [ 73/ 93] [ 67/ 88] [ 64/ 93] [ 69/ 86] [ 64/ 85] [ 70/ 87] [ 65/ 92] [ 69/ 92] [ 64/ 90] [ 66/ 94] 
[ 68/ 92] [ 69/ 89] [ 66/ 94] [ 68/ 85] [ 65/ 90] [ 64/ 89] [ 71/ 92] [ 64/ 92] [ 71/ 94] [ 73/ 89] [ 73/ 85] [ 65/ 90] [ 68/ 94] [ 67/ 85] [ 65/ 93] [ 65/ 87] [ 65/ 93] [ 66/ 89] [ 67/ 88] [ 70/ 94] [ 67/ 90] [ 66/ 92] [ 65/ 90] [ 69/ 87] [ 71/ 93] [ 67/ 93] [ 70/ 90] [ 69/ 89] [ 64/ 89] [ 69/ 94] 
[ 64/ 91] [ 67/ 88] [ 70/ 89] [ 67/ 89] [  0/ 94] [ 69/ 86] [ 68/ 93] [ 73/ 93] [ 73/ 92] [ 66/ 87] [ 70/ 85] [ 73/ 91] [ 67/ 94] [ 69/ 89] [ 71/ 94] [ 67/ 87] [ 64/ 85] [ 64/ 89] [ 67/ 90] [ 68/ 93] [ 70/ 94] [ 65/ 92] [ 65/ 86] [ 73/ 92] [ 67/ 86] [ 73/ 89] [ 64/ 86] [ 65/ 89] [ 69/ 88] [ 71/ 91] 
[ 67/ 85] [ 67/ 86] [ 67/ 86] [ 71/ 88] [ 71/ 92] [ 73/ 85] [ 65/ 86] [ 73/ 85] [ 69/ 86] [ 67/ 90] [ 73/ 94] [ 65/ 93] [ 73/ 94] [ 69/ 91] [ 67/ 94] [ 70/ 88] [ 68/ 88] [ 73/ 86] [ 67/ 85] [ 66/ 93] [ 67/ 93] [ 73/ 85] [ 70/ 90] [ 66/ 89] [ 70/ 86] [ 64/ 85] [ 69/ 89] [ 70/ 90] [ 67/ 91] [ 67/ 86] 
[ 72/ 89] [ 72/ 92] [ 65/ 89] [ 71/ 85] [ 69/ 90] [ 70/ 92] [ 68/ 89] [ 71/ 91] [ 71/ 87] [ 73/ 94] [ 67/ 91] [ 66/ 86] [ 67/ 85] [ 69/ 89] [ 73/ 93] [ 72/ 85] [ 64/ 92] [ 71/ 93] [ 72/ 86] [ 70/ 93] [ 70/ 88] [ 64/ 91] [ 71/ 91] [ 68/ 94] [ 64/ 91] [ 68/ 91] [ 66/ 86] [ 67/ 86] [ 73/ 87] [ 68/ 85] 
[ 65/ 86] [ 73/ 94] [ 73/ 90] [ 65/ 89] [ 68/ 93] [ 69/ 89] [ 64/ 87] [ 72/ 92] [ 65/ 92] [ 67/ 91] [ 64/ 88] [ 71/ 88] [ 68/ 93] [ 69/ 90] [ 66/ 88] [ 65/ 91] [ 67/ 93] [ 70/ 94] [ 71/ 93] [ 69/ 85] [ 72/ 92] [ 66/ 90] [ 70/ 94] [ 70/ 92] [ 70/ 88] [ 65/ 88] [ 71/ 85] [ 65/ 86] [ 65/ 87] [ 73/ 86] 
[ 72/ 91] [ 64/ 94] [ 67/ 93] [ 69/ 88] [ 65/ 93] [ 65/ 87] [ 67/ 94] [ 64/ 88] [ 65/ 94] [ 73/ 88] [ 70/ 87] [ 65/ 87] [ 72/ 85] [ 71/ 94] [ 65/ 94] [ 73/ 94] [ 64/ 93] [ 65/ 89] [ 64/ 88] [ 72/ 91] [ 64/ 89] [ 65/ 94] [ 68/ 89] [ 71/ 91] [ 69/ 90] [ 72/ 87] [ 70/ 93] [ 65/ 94] [ 65/ 85] [ 64/ 92] 
[ 66/ 90] [ 67/ 88] [ 66/ 94] [ 70/ 89] [ 70/ 88] [ 73/ 92] [ 69/ 89] [ 69/ 90] [ 73/ 91] [ 73/ 85] [ 69/ 87] [ 69/ 91] [ 72/ 88] [ 68/ 92] [ 73/ 87] [ 66/ 91] [ 71/ 86] [ 66/ 89] [ 73/ 89] [ 69/ 85] [ 71/ 85] [ 72/ 92] [ 73/ 87] [ 73/ 93] [ 67/ 87] [ 68/ 87] [ 69/ 91] [ 70/ 90] [ 71/ 86] [ 71/ 94] 
[ 70/ 90] [ 66/ 86] [ 66/ 87] [ 72/ 94] [ 70/ 93] [ 68/ 86] [ 64/ 86] [ 70/ 90] [ 69/ 85] [ 65/ 93] [ 71/ 94] [ 65/ 85] [ 70/ 87] [ 66/ 87] [ 67/ 93] [ 71/ 94] [ 70/ 92] [ 68/ 94] [ 67/ 89] [ 69/ 85] [ 66/ 94] [ 69/ 94] [ 69/ 92] [ 64/ 88] [ 64/ 85] [ 64/ 85] [ 70/ 94] [ 67/ 94] [ 66/ 92] [ 70/ 85] 
[ 65/ 90] [ 64/ 93] [ 69/ 90] [ 71/ 85] [ 68/ 94] [ 73/ 88] [ 71/ 86] [ 66/ 87] [ 68/ 88] [ 67/ 89] [ 66/ 87] [ 65/ 94] [ 70/ 86] [ 64/ 91] [ 69/ 88] [ 69/ 86] [ 71/ 88] [ 73/ 89] [ 65/ 91] [ 72/ 91] [ 71/ 89] [ 66/ 88] [ 66/ 89] [ 73/ 93] [ 70/ 93] [ 67/ 93] [ 69/ 88] [ 71/ 90] [ 72/ 89] [ 64/ 92] 
[ 73/ 90] [ 66/ 93] [ 73/ 90] [ 65/ 90] [ 71/ 89] [ 73/ 85] [ 71/ 89] [ 72/ 91] [ 66/ 86] [ 70/ 91] [ 70/ 92] [ 71/ 85] [ 65/ 91] [ 65/ 88] [ 68/ 86] [ 69/ 86] [ 69/ 89] [ 73/ 86] [ 70/ 91] [ 68/ 87] [ 73/ 89] [ 64/ 94] [ 66/ 87] [ 71/ 90] [ 68/ 85] [ 66/ 90] [ 71/ 88] [ 66/ 92] [ 65/ 90] [ 67/ 88] 
[ 69/ 93] [ 68/ 88] [ 65/ 91] [ 69/ 88] [ 69/ 93] [ 72/ 87] [ 72/ 86] [ 64/ 86] [ 70/ 92] [ 73/ 86] [ 68/ 91] [ 68/ 93] [ 69/ 93] [ 66/ 92] [ 70/ 86] [ 65/ 90] [ 68/ 94] [ 64/ 90] [ 70/ 88] [ 70/ 86] [ 72/ 93] [ 66/ 91] [ 67/ 87] [ 64/ 93] [ 70/ 93] [ 67/ 86] [ 67/ 87] [ 72/ 94] [ 65/ 85] [ 73/ 86] 
